111111111111111
100LOL0000P0001
1E000420C000001
10000ABCDE00001
111111111111111