1111111111111111111111111
1111000000111100000001111
111000C00001100000C000111
1100000000000000000000011
1000000000000000000000001
1000000000000000000000001
11000C000000P0000000C0011
1110000000000000000000111
1111000000000000000001111
1111100000000000000011111
1111110000000000000111111
1111111100000000011111111
111111111110E011111111111
1111111111111111111111111