11111111
10000001
10000EP0
11111111