111111111111111
1000000000P0001
1E000000C0000011
100000000000001
111111111111111