1111111
1E0P0C1
1000001
1111111