11111111111111111111
1P1100C00000C0000011
10011010111100001011
101110110011C1111111
100C0011111101111111
111111001111000000E1
11111111111111111111