11111111
10000001
1000P0C0
11111111