11111111
10000001
10000EC0
11111111