11111111
10000001
1000PEC0
11111111