111111111111111
100LOL0000P0001
1E000420C000001
10000ABCDE0K001
111111111111111