11111111111111111111111111111111111111
100000000000000000C0000000000000000001
10000K00000000000000000000000000000001
10000000000000000000001000000000000001
10000000000010000000000000000000000001
10011111110000000000000000000100000001
1K000000000000000000000000000000000001
10000000C100000000000000C0010000000001
1000000CK1000000K0K0K0000001000C000001
10000000C100K00000E00000K000000K000001
100K000C01000000K0K0K0000001000K000001
10000000C10000000K0K00000001000K000001
100000000111000000K0000000010000000001
100000K0011100000000000000010000C00001
100000000011000000K00C0000110000000001
10000000001111111111111111100000000001
100000C0000000000000000000000000000001
10010000000000000010000000000C00000001
1000000C0000000000P000000C000000C000K1
11111111111111111111111111111111111111