1111111111111111111
1KKKKKKKKKKKKKKKKK1
1KKKKKKKKKKKKKKKKK1
1KKKKKKKKKPKKKKKKK1
1KKKKKK000000111KK1
1111KKKKKKCCCCCCKK1
1KKKKKKKKKKCCCCC111
11111111111KKEKK111
1111111111111111111