1111111111111111111111111
1111000000111110000001111
111000C00001110000C000111
1100000000001000000000011
1000000000000000000000001
1000000000000000000000001
11000C000000P0000000C0011
1110000000000000000000111
1111000K0K0K0K0K00K001111
1111100000000000000011111
1111110000K0000K000111111
1111111100000000011111111
111111111110E011111111111
1111111111111111111111111