1111111
1EKP001
10000C1
1111111