1111111
1E0P0C1
100K001
1111111