1111111111111111111111
1010000K11101110101111
1010100111111111111011
1000000P000000000K1111
1010100001111010011011
1110111011101010001011
1000111011111010111011
1010101011111110101011
1110111010001010111011
1000C00C101010000000E1
1111111111111111111111
