111111111111
1000CCCC0001
10CCCCCCCC01
1011CCCC1101
100111111001
10000000K001
10000K000001
100K00000001
1000E11K00P1
111111111111