111111111111
1000CCCC0001
10CCCCCCCC01
1011CCCC1101
10K111111001
10K000K0K001
100K00000001
1K00KKK00001
1KK0E11K00P1
111111111111