11111111111111111111
1P1100C00000C0000011
100110K011100K001011
101110100011C1111111
100C0000111101111111
111000C01111000000E1
11111111111111111111
