11111111111111111111
1P1100C00000C0000011
100110K0111100K01011
101110110011C1111111
100C0011111101111111
111111001111000000E1
11111111111111111111