1111111111111111111111111
1E0000000000000C00000C001
10100101001K0000101001001
101001001K101010001001001
1P0000000C00C000K00000001
1111111111111111111111111