111111111111
1000CCCC0001
10CCCCCCCC01
1011CCCC1101
100111111001
100000000001
100000000001
100000000001
1000E11000P1
111111111111