11111111
10000001
1K000EP1
11111111