11111111
10000001
1K00P0C0
11111111