11111111
10000001
1E00P0C0
11111111