11111111
10K00001
10000EC0
11111111