11111111
100K0001
1000PEC0
11111111